{
  "collision": [
    [
      2, 2, 2, 2, 2, 2, 2, 2, 2, 2, 2, 2, 2, 2, 2, 2, 2, 2, 2, 2, 2, 2, 2, 2, 2,
      2, 2, 2, 2, 2, 2, 3, 3, 2, 2, 2, 2, 2, 2, 2
    ],
    [
      2, 2, 2, 2, 2, 2, 2, 2, 2, 3, 2, 2, 2, 2, 2, 2, 2, 2, 2, 2, 2, 2, 2, 2, 2,
      2, 2, 1, 1, 2, 4, 0, 0, 13, 3, 2, 2, 2, 2, 2
    ],
    [
      2, 2, 2, 2, 2, 2, 2, 2, 12, 0, 3, 2, 2, 3, 3, 3, 2, 2, 2, 2, 2, 2, 2, 2,
      3, 3, 12, 0, 0, 5, 1, 0, 0, 0, 0, 5, 2, 2, 2, 2
    ],
    [
      2, 3, 3, 3, 1, 2, 2, 4, 0, 0, 0, 3, 12, 0, 0, 0, 13, 2, 2, 2, 2, 2, 1, 0,
      0, 0, 0, 0, 6, 2, 0, 0, 0, 0, 0, 13, 2, 2, 2, 2
    ],
    [
      4, 0, 0, 0, 5, 2, 3, 12, 0, 0, 0, 0, 0, 0, 0, 0, 0, 5, 2, 2, 2, 4, 0, 0,
      0, 0, 0, 0, 13, 12, 0, 0, 0, 0, 0, 0, 13, 2, 2, 2
    ],
    [
      4, 0, 0, 0, 13, 12, 0, 0, 0, 0, 0, 0, 0, 0, 0, 0, 0, 13, 2, 2, 2, 4, 0, 0,
      0, 0, 0, 0, 0, 0, 0, 0, 0, 0, 0, 0, 0, 5, 2, 2
    ],
    [
      1, 7, 0, 0, 0, 0, 0, 0, 0, 0, 0, 0, 0, 0, 0, 0, 0, 0, 13, 3, 2, 2, 1, 2,
      8, 0, 0, 0, 0, 0, 0, 0, 0, 0, 9, 1, 1, 2, 2, 2
    ],
    [
      2, 1, 1, 7, 0, 0, 0, 0, 0, 0, 6, 7, 0, 0, 0, 0, 0, 0, 0, 0, 5, 2, 2, 4, 0,
      0, 0, 0, 0, 0, 6, 2, 0, 0, 0, 5, 2, 2, 2, 2
    ],
    [
      2, 2, 2, 4, 0, 0, 0, 9, 1, 1, 2, 2, 1, 7, 0, 0, 0, 0, 0, 3, 2, 2, 2, 2, 1,
      8, 0, 0, 0, 6, 3, 3, 1, 1, 1, 2, 2, 2, 2, 2
    ],
    [
      3, 3, 3, 12, 0, 0, 0, 0, 1, 1, 2, 2, 2, 4, 0, 0, 0, 0, 0, 0, 13, 3, 3, 4,
      0, 0, 0, 0, 6, 12, 0, 0, 0, 13, 3, 3, 3, 3, 3, 3
    ],
    [
      0, 0, 0, 0, 0, 0, 0, 0, 0, 0, 1, 1, 2, 2, 7, 0, 0, 0, 0, 0, 0, 0, 0, 5, 8,
      0, 0, 3, 12, 0, 0, 0, 0, 0, 0, 0, 0, 0, 0, 0
    ],
    [
      0, 0, 0, 0, 0, 0, 0, 0, 0, 0, 0, 0, 1, 1, 1, 8, 0, 0, 0, 0, 0, 0, 3, 12,
      0, 0, 0, 0, 0, 0, 0, 0, 0, 0, 0, 0, 0, 0, 0, 0
    ],
    [
      1, 1, 1, 1, 7, 0, 0, 0, 0, 0, 0, 0, 0, 0, 0, 0, 0, 0, 6, 7, 0, 0, 0, 0, 0,
      0, 1, 0, 0, 0, 0, 0, 9, 8, 0, 0, 0, 0, 6, 1
    ],
    [
      2, 2, 2, 2, 2, 1, 1, 8, 0, 0, 0, 0, 0, 0, 0, 0, 6, 1, 1, 1, 0, 0, 0, 0, 0,
      9, 1, 1, 2, 1, 8, 0, 0, 0, 0, 0, 9, 1, 1, 1
    ],
    [
      2, 2, 2, 2, 11, 3, 12, 0, 0, 0, 6, 7, 0, 0, 6, 1, 3, 2, 4, 0, 0, 0, 0, 0,
      0, 0, 0, 13, 2, 4, 0, 0, 0, 0, 0, 0, 0, 5, 2, 2
    ],
    [
      2, 2, 2, 12, 0, 0, 0, 0, 0, 0, 5, 4, 0, 0, 13, 1, 0, 0, 13, 8, 0, 0, 9, 1,
      1, 8, 0, 0, 13, 1, 8, 0, 0, 0, 6, 1, 1, 2, 2, 2
    ],
    [
      2, 2, 4, 0, 0, 0, 0, 0, 0, 6, 2, 1, 0, 0, 0, 0, 0, 0, 0, 0, 0, 0, 0, 0, 0,
      0, 0, 0, 0, 0, 0, 0, 0, 0, 1, 0, 13, 1, 2, 2
    ],
    [
      2, 2, 4, 0, 0, 0, 0, 10, 0, 5, 11, 2, 7, 0, 0, 0, 0, 9, 1, 1, 1, 1, 8, 0,
      0, 9, 1, 1, 1, 1, 8, 0, 0, 10, 0, 0, 0, 0, 5, 2
    ],
    [
      2, 2, 1, 8, 0, 0, 0, 0, 0, 11, 0, 5, 2, 1, 1, 1, 0, 0, 0, 0, 0, 0, 0, 0,
      0, 0, 0, 0, 5, 4, 0, 0, 0, 0, 0, 0, 0, 0, 5, 2
    ],
    [
      2, 2, 4, 0, 0, 0, 6, 7, 0, 0, 0, 13, 11, 11, 11, 11, 8, 0, 0, 6, 7, 0, 9,
      1, 1, 1, 1, 1, 11, 12, 0, 0, 6, 7, 0, 0, 6, 1, 2, 2
    ],
    [
      2, 2, 2, 1, 1, 1, 2, 2, 1, 7, 0, 0, 0, 0, 0, 0, 0, 0, 6, 2, 2, 0, 0, 0, 0,
      0, 0, 0, 0, 0, 0, 6, 2, 2, 1, 1, 1, 2, 2, 2
    ],
    [
      2, 2, 2, 2, 2, 2, 2, 2, 1, 1, 1, 1, 1, 1, 1, 1, 1, 1, 2, 2, 2, 1, 1, 1, 1,
      1, 1, 1, 1, 1, 1, 2, 2, 2, 2, 2, 2, 2, 2, 2
    ]
  ],
  "wall": [
    [
      1, 1, 1, 1, 1, 1, 1, 1, 1, 1, 1, 1, 1, 1, 1, 1, 1, 1, 1, 1, 1, 1, 1, 1, 1,
      1, 1, 1, 1, 1, 1, 1, 1, 1, 1, 1, 1, 1, 1, 1
    ],
    [
      1, 1, 1, 1, 1, 1, 1, 1, 1, 1, 1, 1, 1, 1, 1, 1, 1, 1, 1, 1, 1, 1, 1, 1, 1,
      1, 1, 1, 1, 1, 1, 1, 1, 1, 1, 1, 1, 1, 1, 1
    ],
    [
      1, 1, 1, 1, 1, 1, 1, 1, 1, 1, 1, 1, 1, 1, 1, 1, 1, 1, 1, 1, 1, 1, 1, 1, 1,
      1, 1, 1, 1, 1, 1, 1, 1, 1, 1, 1, 1, 1, 1, 1
    ],
    [
      1, 1, 1, 1, 1, 1, 1, 1, 1, 1, 1, 1, 0, 1, 1, 1, 0, 0, 0, 0, 0, 0, 0, 1, 1,
      1, 1, 1, 1, 1, 1, 1, 1, 1, 1, 1, 1, 1, 1, 1
    ],
    [
      1, 1, 1, 1, 1, 0, 0, 0, 1, 1, 1, 1, 1, 1, 1, 1, 1, 1, 0, 0, 0, 0, 1, 1, 1,
      1, 1, 1, 1, 1, 1, 1, 1, 1, 1, 1, 1, 1, 1, 1
    ],
    [
      1, 1, 1, 1, 1, 1, 1, 1, 1, 1, 1, 1, 0, 1, 1, 1, 1, 1, 1, 1, 0, 0, 1, 1, 1,
      1, 1, 1, 1, 1, 1, 1, 1, 1, 1, 1, 1, 1, 1, 1
    ],
    [
      1, 1, 1, 1, 1, 1, 1, 1, 1, 1, 1, 0, 0, 1, 1, 1, 1, 1, 1, 1, 0, 0, 1, 1, 1,
      1, 1, 1, 1, 1, 0, 0, 0, 1, 1, 1, 1, 1, 1, 1
    ],
    [
      1, 1, 1, 1, 1, 1, 1, 1, 1, 0, 0, 0, 0, 1, 1, 1, 1, 0, 1, 0, 0, 1, 1, 1, 1,
      1, 1, 1, 0, 1, 1, 1, 1, 1, 1, 0, 1, 1, 1, 1
    ],
    [
      1, 1, 1, 1, 1, 1, 1, 0, 0, 0, 0, 0, 0, 0, 1, 1, 1, 1, 1, 0, 0, 1, 1, 1, 1,
      0, 1, 1, 0, 0, 0, 0, 0, 0, 1, 1, 0, 1, 1, 1
    ],
    [
      1, 1, 1, 1, 1, 1, 1, 0, 0, 1, 0, 0, 0, 0, 1, 0, 0, 0, 1, 1, 1, 1, 1, 1, 1,
      1, 1, 0, 0, 0, 1, 1, 1, 1, 0, 0, 0, 0, 1, 1
    ],
    [
      1, 1, 1, 1, 1, 1, 1, 1, 1, 1, 1, 0, 0, 0, 1, 1, 1, 1, 1, 1, 1, 1, 1, 0, 0,
      1, 1, 0, 0, 0, 1, 0, 0, 0, 0, 1, 1, 1, 1, 1
    ],
    [
      1, 1, 1, 1, 1, 1, 1, 1, 0, 1, 1, 1, 0, 0, 0, 0, 1, 0, 0, 0, 1, 1, 1, 1, 1,
      1, 1, 1, 1, 1, 1, 1, 0, 0, 0, 0, 0, 1, 1, 1
    ],
    [
      1, 1, 1, 1, 1, 1, 1, 1, 1, 1, 1, 1, 1, 1, 1, 1, 1, 0, 0, 0, 0, 1, 1, 1, 1,
      1, 1, 1, 1, 1, 1, 0, 0, 0, 0, 0, 1, 1, 1, 1
    ],
    [
      1, 1, 1, 1, 1, 1, 1, 1, 1, 1, 1, 1, 1, 1, 1, 1, 1, 0, 0, 0, 0, 0, 0, 1, 1,
      1, 1, 1, 1, 1, 0, 0, 0, 0, 0, 1, 1, 1, 1, 1
    ],
    [
      1, 1, 1, 1, 1, 1, 1, 1, 1, 1, 1, 0, 1, 1, 1, 0, 0, 0, 1, 1, 0, 0, 0, 1, 1,
      1, 1, 1, 1, 1, 1, 0, 0, 1, 1, 1, 1, 1, 1, 1
    ],
    [
      1, 1, 1, 1, 1, 1, 1, 1, 1, 1, 1, 1, 1, 1, 1, 0, 0, 1, 1, 1, 1, 0, 0, 0, 0,
      1, 1, 1, 1, 1, 1, 0, 0, 1, 1, 1, 1, 1, 1, 1
    ],
    [
      1, 1, 1, 1, 1, 1, 1, 1, 1, 1, 1, 1, 1, 1, 1, 1, 0, 0, 1, 1, 1, 1, 1, 1, 1,
      1, 1, 1, 1, 0, 0, 0, 1, 1, 1, 1, 1, 1, 1, 1
    ],
    [
      1, 1, 1, 1, 1, 1, 1, 1, 1, 1, 1, 1, 1, 1, 1, 1, 1, 0, 1, 1, 1, 1, 1, 1, 1,
      1, 1, 1, 1, 1, 1, 1, 1, 1, 1, 1, 1, 1, 1, 1
    ],
    [
      1, 1, 1, 1, 1, 1, 1, 1, 1, 1, 1, 1, 1, 1, 1, 1, 1, 1, 1, 1, 1, 1, 1, 1, 1,
      1, 1, 1, 1, 1, 1, 1, 1, 1, 1, 1, 1, 1, 1, 1
    ],
    [
      1, 1, 1, 1, 1, 1, 1, 1, 1, 1, 1, 1, 1, 1, 1, 1, 1, 1, 1, 1, 1, 1, 1, 1, 1,
      1, 1, 1, 1, 1, 1, 1, 1, 1, 1, 1, 1, 1, 1, 1
    ],
    [
      1, 1, 1, 1, 1, 1, 1, 1, 1, 1, 1, 1, 1, 1, 1, 1, 1, 1, 1, 1, 1, 1, 1, 1, 1,
      1, 1, 1, 1, 1, 1, 1, 1, 1, 1, 1, 1, 1, 1, 1
    ],
    [
      1, 1, 1, 1, 1, 1, 1, 1, 1, 1, 1, 1, 1, 1, 1, 1, 1, 1, 1, 1, 1, 1, 1, 1, 1,
      1, 1, 1, 1, 1, 1, 1, 1, 1, 1, 1, 1, 1, 1, 1
    ]
  ],
  "bg": [
    [
      1, 1, 1, 1, 1, 1, 1, 1, 1, 1, 1, 1, 1, 1, 1, 1, 1, 1, 1, 1, 1, 1, 1, 1, 1,
      1, 1, 1, 1, 1, 1, 1, 1, 1, 1, 1, 1, 1, 1, 1
    ],
    [
      1, 1, 1, 1, 1, 1, 1, 1, 1, 1, 1, 1, 1, 1, 1, 1, 1, 1, 1, 1, 1, 1, 1, 1, 1,
      1, 1, 1, 1, 1, 1, 1, 1, 1, 1, 1, 1, 1, 1, 1
    ],
    [
      1, 1, 1, 1, 1, 1, 1, 1, 1, 1, 1, 1, 1, 1, 1, 1, 1, 1, 1, 1, 1, 1, 1, 1, 1,
      1, 1, 1, 1, 1, 1, 1, 1, 1, 1, 1, 1, 1, 1, 1
    ],
    [
      1, 1, 1, 1, 1, 1, 1, 1, 1, 1, 1, 1, 1, 1, 1, 1, 1, 1, 1, 1, 1, 1, 1, 1, 1,
      1, 1, 1, 1, 1, 1, 1, 1, 1, 1, 1, 1, 1, 1, 1
    ],
    [
      1, 1, 1, 1, 1, 1, 1, 1, 1, 1, 1, 1, 1, 1, 1, 1, 1, 1, 1, 1, 1, 1, 1, 1, 1,
      1, 1, 1, 1, 1, 1, 1, 1, 1, 1, 1, 1, 1, 1, 1
    ],
    [
      1, 1, 1, 1, 1, 1, 1, 1, 1, 1, 1, 1, 1, 1, 1, 1, 1, 1, 1, 1, 1, 1, 1, 1, 1,
      1, 1, 1, 1, 1, 1, 1, 1, 1, 1, 1, 1, 1, 1, 1
    ],
    [
      1, 1, 1, 1, 1, 1, 1, 1, 1, 1, 1, 1, 1, 1, 1, 1, 1, 1, 1, 1, 1, 1, 1, 1, 1,
      1, 1, 1, 1, 1, 1, 1, 1, 1, 1, 1, 1, 1, 1, 1
    ],
    [
      1, 1, 1, 1, 1, 1, 1, 1, 1, 1, 1, 1, 1, 1, 1, 1, 1, 1, 1, 1, 1, 1, 1, 1, 1,
      1, 1, 1, 1, 1, 1, 1, 1, 1, 1, 1, 1, 1, 1, 1
    ],
    [
      1, 1, 1, 1, 1, 1, 1, 1, 1, 1, 1, 1, 1, 1, 1, 1, 1, 1, 1, 1, 1, 1, 1, 1, 1,
      1, 1, 1, 1, 1, 1, 1, 1, 1, 1, 1, 1, 1, 1, 1
    ],
    [
      1, 1, 1, 1, 1, 1, 1, 1, 1, 1, 1, 1, 1, 1, 1, 1, 1, 1, 1, 1, 1, 1, 1, 1, 1,
      1, 1, 1, 1, 1, 1, 1, 1, 1, 1, 1, 1, 1, 1, 1
    ],
    [
      1, 1, 1, 1, 1, 1, 1, 1, 1, 1, 1, 1, 1, 1, 1, 1, 1, 1, 1, 1, 1, 1, 1, 1, 1,
      1, 1, 1, 1, 1, 1, 1, 1, 1, 1, 1, 1, 1, 1, 1
    ],
    [
      1, 1, 1, 1, 1, 1, 1, 1, 1, 1, 1, 1, 1, 1, 1, 1, 1, 1, 1, 1, 1, 1, 1, 1, 1,
      1, 1, 1, 1, 1, 1, 1, 1, 1, 1, 1, 1, 1, 1, 1
    ],
    [
      1, 1, 1, 1, 1, 1, 1, 1, 1, 1, 1, 1, 1, 1, 1, 1, 1, 1, 1, 1, 1, 1, 1, 1, 1,
      1, 1, 1, 1, 1, 1, 1, 1, 1, 1, 1, 1, 1, 1, 1
    ],
    [
      1, 1, 1, 1, 1, 1, 1, 1, 1, 1, 1, 1, 1, 1, 1, 1, 1, 1, 1, 1, 1, 1, 1, 1, 1,
      1, 1, 1, 1, 1, 1, 1, 1, 1, 1, 1, 1, 1, 1, 1
    ],
    [
      1, 1, 1, 1, 1, 1, 1, 1, 1, 1, 1, 1, 1, 1, 1, 1, 1, 1, 1, 1, 1, 1, 1, 1, 1,
      1, 1, 1, 1, 1, 1, 1, 1, 1, 1, 1, 1, 1, 1, 1
    ],
    [
      1, 1, 1, 1, 1, 1, 1, 1, 1, 1, 1, 1, 1, 1, 1, 1, 1, 1, 1, 1, 1, 1, 1, 1, 1,
      1, 1, 1, 1, 1, 1, 1, 1, 1, 1, 1, 1, 1, 1, 1
    ],
    [
      1, 1, 1, 1, 1, 1, 1, 1, 1, 1, 1, 1, 1, 1, 1, 1, 1, 1, 1, 1, 1, 1, 1, 1, 1,
      1, 1, 1, 1, 1, 1, 1, 1, 1, 1, 1, 1, 1, 1, 1
    ],
    [
      1, 1, 1, 1, 1, 1, 1, 1, 1, 1, 1, 1, 1, 1, 1, 1, 1, 1, 1, 1, 1, 1, 1, 1, 1,
      1, 1, 1, 1, 1, 1, 1, 1, 1, 1, 1, 1, 1, 1, 1
    ],
    [
      1, 1, 1, 1, 1, 1, 1, 1, 1, 1, 1, 1, 1, 1, 1, 1, 1, 1, 1, 1, 1, 1, 1, 1, 1,
      1, 1, 1, 1, 1, 1, 1, 1, 1, 1, 1, 1, 1, 1, 1
    ],
    [
      1, 1, 1, 1, 1, 1, 1, 1, 1, 1, 1, 1, 1, 1, 1, 1, 1, 1, 1, 1, 1, 1, 1, 1, 1,
      1, 1, 1, 1, 1, 1, 1, 1, 1, 1, 1, 1, 1, 1, 1
    ],
    [
      1, 1, 1, 1, 1, 1, 1, 1, 1, 1, 1, 1, 1, 1, 1, 1, 1, 1, 1, 1, 1, 1, 1, 1, 1,
      1, 1, 1, 1, 1, 1, 1, 1, 1, 1, 1, 1, 1, 1, 1
    ],
    [
      1, 1, 1, 1, 1, 1, 1, 1, 1, 1, 1, 1, 1, 1, 1, 1, 1, 1, 1, 1, 1, 1, 1, 1, 1,
      1, 1, 1, 1, 1, 1, 1, 1, 1, 1, 1, 1, 1, 1, 1
    ]
  ]
}
